g, g, g, g, g
g, g, g, g, g
g, 1, g, g, g
g, 0, 4, g, g
g, 3, 5, g, g
g, 6, g, g, g
